................
.E.   .    ... .
. . . .    ... .
. . .   ..  A  .
.   . .  ... . .
.              .
................
