.......................................................
.......................................................
..E                                                  ..
.................................................... ..
..                                                   ..
.. ....................................................
..                                                   ..
.................................................... ..
..                                                   ..
.. ....................................................
..                                                   ..
.................................................... ..
..                                                   ..
.. ....................................................
..                                                   ..
.................................................... ..
..                                                   ..
.. ....................................................
..                                                  A..
.......................................................
.......................................................